******************************************************************************
*   .....................                            ........................*
*   .                   .          ...................    .         .    .   *
*   .     ..........    .          .        .        .    .         .    .   *
*   .              .    ............        .        .    .         .    ....*
*   .              .    .     .             .        .    .         ......   *
*   ................    .     ........................    .            .     *
*                       .     .                      .    ......    ....     *
*   ......................................           .         .    .  .     *
*   .            .      .                .............         .    .  .     *
*   ..............      .    .............         .      ......    .  ......*
*   .            .      .                          .      .         .        *
*   .......      ...............                   .      .   .......  ......*
*         .      .             .....................      .   .        .     *
* ................             .                              ..........     *
*         .                    .                                             *
******************************************************************************
